1111111111111111111111111111111111
1E0000000000000C00000C000000000001
1010010100100000101001000000010101
1010010010101010001001000000010101
1P0000000C0000000000000000000000C1
1000000000000000000000000000000001
1000000000011111111111111111111111
1111111000010000001000000000000001
1000001000010001000000000000000001
1000001000000001111110000000000001
1000001000010001111110000000000001
1000001000000001111110000000000001
1000000000011111111110000000000001
1000000000000000000000000000000001
1000000000000000000000000000000001
1000000000000000000000000000000001
1000000000000000000000000000000001
1000000000000000000000000000000001
1000000000000000000000000000000001
1000000000000000000000000000000001
1000000000000000000000000000000001
1000000000000000000000000000000001
1000000000000000000000000000000001
1000000000000000000000000000000001
1000000000000000000000000000000001
1000000000000000000000000000000001
1000000000000000000000000000000001
1000000000000000000000000000000001
1000000000000000000000000000000001
1111111111111111111111111111111111